/\000000000000
||000000000000
|B000000000000
(\000000000000
0|000000000000
0(=r0000000000
